[layer]
type=Tile Layer 1
data=
1,0,0,0,1,1,1,0,0,0,0,
1,1,0,1,0,0,0,1,0,0,0,
1,0,1,0,0,4,0,0,1,0,0,
1,0,0,0,4,0,7,0,0,1,0,
1,0,0,0,5,0,0,0,0,1,0,
1,0,1,0,0,5,0,0,1,0,0,
1,1,0,1,0,0,0,1,0,0,0,
1,0,0,0,1,1,1,0,0,0,0,
0,0,0,0,0,0,0,0,0,0,0,
0,0,0,0,8,0,0,0,0,0,0,
0,0,0,0,0,0,0,0,0,0,0.
[layer]
type=Tile Layer 2
data=
20,0,0,0,20,20,20,0,0,0,0,
20,20,0,20,0,0,0,20,0,0,0,
20,0,20,0,0,20,0,0,20,0,0,
20,0,0,0,20,0,7,0,0,5,0,
20,0,0,0,20,0,0,0,0,5,0,
20,0,20,0,0,20,0,0,20,0,0,
20,20,0,20,0,0,0,20,0,0,0,
20,0,0,0,20,20,20,0,0,0,0,
0,0,0,0,0,0,0,0,0,0,0,
0,0,0,0,8,0,0,0,0,0,0,
0,0,0,0,0,0,0,0,0,0,0.
