[layer]
type=Tile Layer 1
data=
5,5,5,5,5,5,5,5,5,5,3,
1,0,0,0,0,0,0,0,0,0,3,
1,1,1,1,1,1,1,1,1,0,3,
1,0,0,0,0,0,0,0,0,0,3,
1,0,1,2,2,1,1,1,1,1,3,
1,0,0,0,0,0,0,0,0,0,3,
1,1,4,4,4,4,4,4,4,0,3,
0,0,0,0,0,0,0,0,0,0,0,
0,0,0,0,0,0,0,0,0,0,0,
0,0,0,0,0,0,0,0,0,0,0,
0,0,0,0,0,0,0,0,0,0,0.
[layer]
type=Tile Layer 2
data=
5,5,5,5,5,5,5,5,5,5,5,
5,0,0,0,0,0,0,0,0,0,5,
5,15,15,15,15,15,15,15,15,0,5,
5,0,0,0,0,0,0,0,0,0,5,
5,0,15,15,15,15,15,15,15,15,5,
5,0,0,0,0,0,0,0,0,0,5,
10,10,10,10,10,10,10,10,10,0,10,
0,0,0,0,0,0,0,0,0,0,0,
0,0,0,0,0,0,0,0,0,0,0,
0,0,0,0,0,0,0,0,0,0,0,
0,0,0,0,0,0,0,0,0,0,0.
